#	#	#	#	#	#	#	#	#	#	#	#	#	#	#	#	#	#	#	#	#	#		#	#	#	#	#	A	#	
											#	#	#	#	#	#	#	#	#	#	#		#	#	#	#	#		#	
#	#	#		#	#	#	#	#	#												#						#		#	
#	#	#		#					#	#		#	#		#	#	#	#	#		#		#	#	#		#		#	
#	#	#		#		#	#		#	#		#	#		#	#	#	#	#		#		#	#	#		#		#	
#	#	#				#	#	#	#	#		#						#	#	#	#		#	#	#	#	#		#	
#	#	#	#	#		#	#		#	#		#	#	#	#	#		#	#	#	#					#			#	
#	#	#	#	#		#							#	#	#	#							#	#		#		#	#	
#	#					#		#	#	#	#						#	#	#	#	#	#	#	#	#	#		#		
#	#		#	#	#	#					#		#	#	#	#	#	#	#	#	#	#	#	#		#				
#	#		#	#	#	#	#		#		#		#	#												#		#		
#	#								#				#	#		#	#	#	#	#	#	#	#		#	#		#	#	
#	#		#	#	#	#	#	#	#	#	#	#	#	#		#	#	#	#	#	#	#	#		#	#			#	
#	#		#	#				#	#	#		#	#	#		#									#	#	#		#	
#	#		#	#		#		#	#	#		#	#	#		#		#	#	#	#	#	#		#	#			#	
#	#		#	#		#										#		#	#						#	#		#	#	
#	#		#	#		#	#	#	#		#	#	#	#	#	#		#	#		#	#	#	#	#	#		#		
#	#		#	#		#	#	#	#		#	#	#	#	#	#		#	#		#	#	#	#	#	#				
#	#		#	#												#		#	#		#							#	#	
#	#		#	#	#	#	#	#	#		#	#	#	#	#	#	#	#	#		#	#	#	#	#	#				
#	#						#	#	#		#	#	#	#		#	#				#	#	#	#	#	#		#	#	
#	#	#	#	#	#											#			#									#	#	
#	#	#	#	#	#	#	#	#	#		#	#	#	#		#		#	#	#	#	#	#	#	#	#	#	#	#	
#	#	#	#	#	#	#	#	#	#	#	#	#	#	#		#								#	#	#	#	#	#	
#	#									#	#	#	#	#		#		#	#	#	#		#	#	#	#	#			
#	#		#	#		#	#	#		#	#	#	#	#		#		#	#	#	#						#		#	
#	#		#	#		#	#	#									#		#	#	#		#	#		#	#		#	
#			#	#		#	#	#	#	#	#	#	#	#	#	#	#		#				#	#					#	
#	#	#	#	#		#	#	#	#	#	#	#	#	#	#	#	#		#	#	#		#	#		#		#	#	
B						#	#	#	#	#	#	#	#	#	#	#	#			#	#	#	#	#	#	#		#	#	

